..I.......I.......I
.SSSSSSSSSSSSSSSSSS
.SSSSSSSSSSSSSSSSSS
.SSSSSSSSSSSSSSSSSSI
SG............RRRRS
ST................S
SI................S
.SSSSSSSSSSSSSSS..SI
..SR..............S
..S...............S
..S...SSSSSSSSSSSSS
.IS...............SI
..S...............S
..SRR........SS...S
..SRRRR......SS..RS
.SSSSSSSSSSSSSS...S
SG................S
ST..............RRS
SI..........RRRRRRSI
.SSSSSSSSSSSSSSSSSS
.SSSSSSSSSSSSSSSSSS
.SSSSSSSSSSSSSSSSSS
..I.......I.......I