..I.........I............I.............I
.SSSSSSSSSSSSSSSSSSSSSSSSSSSSSSSSSSSSSSSSI
.SSSSSSSSSSSSSSSSSSSSSSSSSSSSSSSSSSSSSSSS
.SSSSSSSSSSSSSSSSSSSSSSSSSSSSSSSSSSSSSSSS
SG...................................SSSS
ST....................................SSS
SI..........SSSSSSSSSSSSS..............SS
.SSSSSSSSSSSSSSSSSSSSSSSSSSSSSSSSS......S
..S..............................S......S
..S.SSSSSSSSSSSSSSSSSSSSSSSSSSSS.SRRR...S
..S..S....SS...S...S...S...S...S.S......S
..S..S.SS....S...S...S...S...S.S.S......S
.ISS.S.SSSSSSSSSSSSSSSSSSSSSSSCS.S......SI
..SS.S...........................C...RRRS
..SS.SSSSSSSSSSSSSSSSSSSSSSSSSSSSS......S
..SS....................................SS
..SSSSSSSSSSSSSSSSSSSSSSSSSSSSSSSS.......GS
..SSSSSSSSSSSSSSSSSSSSSSSSSSSSSSSSR......TS
..S...........SSSSSS.....................IS
.Sv....................................SSS
.ST....................................SS
.SI......SS..............SSSS..........SS
..SSSSSSSSSSSSSSSSSSSSSSSSSSSSSSSSSSSSSSSI
..SSSSSSSSSSSSSSSSSSSSSSSSSSSSSSSSSSSSSSS
.SSSSSSSSSSSSSSSSSSSSSSSSSSSSSSSSSSSSSSSS
...I.............I............I........I