..I............I.............I
.ISSSSSSSSSSSSSSSSSSSSSSSSSSSSI
..S..........................S
..S..........................S
..S..........................S
..S..........................S
.SS..........................S
SG...........................S
ST...........................S
SI...........................SI
.SSSSSSSSSSSSSSSSSSSSSSSSSSSSS
.SSSSSSSSSSSSSSSSSSSSSSSSSSSSS
.SSSSSSSSSSSSSSSSSSSSSSSSSSSSS
..I............I.............I