..I............I.............I.............I...........I............I.............I
..SSSSSSSSSSSSSSSSSSSSSSSSSSSSSSSSSSSSSSSSSSSSSSSSSSSSSSSSSSSSSSSSSSSSSSSSSSSSSSSSS
..S...............................................................................S
..S...............................................................................S
..S...............................................................................S
.SS...............................................................................SS
SG.................................................................................GS
ST.................................................................................TS
SI.................................................................................IS
.SSSPPPPPPPPPPPPSPPPPPPPPPPSPPPPPPSPPPPSPPPPPPPPPPSPPPPPPPPPSPPPPPPPSPPPPPPPPPPPPSSS
..SSYYYYSSYYSYYYSYYYYYSYYYYSYYYYYSSYYYYSYYYYSSSYYYSYYYYSYYYYSYYYSYYYSSYYYSSYYYYYYSS
..SSSSSSSSSSSSSSSSSSSSSSSSSSSSSSSSSSSSSSSSSSSSSSSSSSSSSSSSSSSSSSSSSSSSSSSSSSSSSSSSS
..SSSSSSSSSSSSSSSSSSSSSSSSSSSSSSSSSSSSSSSSSSSSSSSSSSSSSSSSSSSSSSSSSSSSSSSSSSSSSSSSS
..I............I.............I.............I............I.............I...........I