..I............I.............I
.ISSSSSSSSSSSSSSSSSSSSSSSSSSSSI
..SRRRRRRRRRRRRRRRRRRRRRRRRRRS
..S...RRRRRRRRRRRRRRRRRRRRRRRS
..S.......RRRRRRRRRRRRRRRRRRRS
..S...........RRRRRRRRRRRRRRRS
.SS................RRRRRRRRRRS
SG....................FFRRRRRS
ST....................FFFFFFFS
SI....................FFFFFFFSI
.SSSSSSSSSSSSSSSSSSSSSSSSSSSSS
.SSSSSSSSSSSSSSSSSSSSSSSSSSSSS
.SSSSSSSSSSSSSSSSSSSSSSSSSSSSS
..I............I.............I